4 4 4 4 4 4 4 4 4 4
4 3 3 3 3 4 6 4 3 4
4 3 0 3 4 3 3 3 4 4
4 3 3 3 6 3 4 4 3 4
4 6 3 3 3 3 3 3 4 4
4 4 4 3 3 9 3 3 4 4
4 4 3 4 3 3 0 3 3 4
4 4 3 4 4 3 3 3 3 4
4 3 3 4 4 4 4 3 3 4
4 4 4 4 4 4 4 4 4 4
