4 4 4 4 4 4 4 4 4 4
4 4 9 4 0 6 3 6 3 4
4 4 3 4 4 4 4 4 3 4
4 4 3 3 3 3 3 4 3 4
4 4 4 4 3 4 4 4 3 4
4 4 3 3 3 4 3 3 3 4
4 4 3 4 4 4 3 4 3 4
4 4 3 3 3 6 3 4 0 4
4 4 4 4 4 4 4 4 4 4
4 4 4 4 4 4 4 4 4 4
